136
40
100101110
100100100
100100100
100100100
111100100
100100100
100100100
100100100
100101110