70
24
000000000000000000101102103000000103102101000000000000000000
000000000000000101102103103000000103103102101000000000000000
000000000000101102103104103000000103104103102101000000000000
000000000101102103104104103101101103104104103102101000000000
000000000101102103104104103102102103104104103102101000000000
000000101102102102103104103102102103104103102102102101000000
000000101102103102102103103103103103103102102103102101000000
000000101102103103102102103104104103102102103103102101000000
000000101102103104103102103104104103102103104103102101000000
000000000102103104104103103104104103103104104103102101000000
000000101102103104104103103104104103103104104103102101000000
000000101102103104103102103104104103102101104103102101000000
000000101102103103102102103104104103102102103103102101000000
000000101102103102102103103103103103103102102103102101000000
000000101102102102103104103102102103104103102102102101000000
000000000101102103104104103102102103104104103102101000000000
000000000101102103104104103101101103104104103102101000000000
000000000000101102103104103000000103104103102101000000000000
000000000000000101102103103000000103103102101000000000000000
000000000000000000101102103000000103102101000000000000000000