70
24
000000101101101000000000000102102000000000000101101101000000
000103103103000000000000000104104000000000000000103103103000
101101101000000000000000102102102102000000000000000101101101
103103000000000000000104104105105104104000000000000000103103
101000000000000000102102105106107105102102000000000000000101
103000000000000104104104105106107105104104104000000000000103
101000000000000000102102105106107105102102000000000000000101
103103000000000000000104104105105104104000000000000000103103
101101101000000000000000102102102102000000000000000101101101
103103103103000000000000000104104000000000000000103103103103
105101101101101000000000000000000000000000000101101101101105
107105103103103103000000000000000000000000103103103103105106
107105101101101101101000000000000000000101101101101101105106
107105103103103103000000000000000000000000103103103103105106
105101101101101000000000000000000000000000000101101101101105
103103103103000000000000000104104000000000000000103103103103
101101101000000000000000102102102102000000000000000101101101
103103000000000000000104104105105104104000000000000000103103
101000000000000000102102105106107105102102000000000000000101
103000000000000104104104105106107105104104104000000000000103