125
40
100101110
010100101
100100101
010101100
100100101
010110100
001000010
010100101
101010011