000000000000000000000000000000000000000101101000000000000
000000000000000000000000102103102104101101101101000000000
000000000000000000103103103102104101101102000101000000000
000000000000000000103103104104101101102102000101000000000
000000000000000103103104101101101103102102102101000000000
000000000000000103104101101000000000102102102000000000000
000000000000000103104101000000000000000102102000000000000
000000000000000104104000000000000000000102102000000000000
000000000000000105101103102103102102102102102000000000000
000000000000105105103103103102103102102102102000000000000
000000000000105101103000000000000000000000000000000000000
000000000000105101103000000000000000000000000000000000000
000000000105101103103000000000000000103102102000000000000
000000000101000103103103000000000000103102102000000000000
000000000101000101101101101000000103102103103000000000000
000000000101101000103103103103103103103102000000000000000
000000000000101101103103103103103102103103000000000000000
000000000000101101101103103103103103103000000000000000000
000000000000000000000000000103103000000000000000000000000