54
18
000000000000110110000000000000000000000000110110000000000000
000000110113000000110000000000000000000110000000113110000000
000110113101113113000110000000000000110000113113101113110000
110101101101101101113000110110110110000113101101101101101110
120120120120120110120113000000000000113120110120120120120120
115115115115115120110120113113113113120110120115115115115115
120120120120115115120110120120120120110120115115120120120120
110120120120120115115120110110110110120115115120120120120110
120110120120120120115115120120120120115115120120120120110120
000120110120120120115000000000000000000115120120120110120000
000000120110120120120115115115115115115120120120110120000000
000000000120110120120120120120120120120120120110120000000000
000000000000120110120120120120120120120120110120000000000000
000000000000000120110120120120120120120110120000000000000000
000000000000000000120110120120120120110120000000000000000000
000000000000000000000120110120120110120000000000000000000000
000000000000000000000000120110110120000000000000000000000000