000000000000110110000000000000000000000000110110000000000000
000000110213000000110000000000000000000110000000213110000000
000110213101213213000110000000000000110000213213101213110000
110101101101101101213000110110110110000213101101101101101110
120120120120120110120213000000000000213120110120120120120120
115115115115115120110120213213213213120110120115115115115115
120120120120115115000110120120120120110120115115120120120120
110120120120120115115000110110110110120115115120120120120120
120110120120120120115115000120120120115115120120120120120120
000120110120120120120115115000000000000115120120120110120000
000000120110120120120120115115115115115120120120110120000000
000000000120110120120120120120120120120120120110120000000000
000000000000120110120120120120120120120120110120000000000000
000000000000000120110120120120120120120110120000000000000000
000000000000000000120110120120120120110120000000000000000000
000000000000000000000120110120120110120000000000000000000000
000000000000000000000000120110110120000000000000000000000000



























